██████████████████████████████████████████████████████████████████████
██  ██                      ██                  ██              ██  ██
██  ██  ██████  ██████████  ██  ██████████  ██  ██  ██████████  ██  ██
██          ██  ██      ██  ██  ██  ██      ██      ██          ██  ██
██████████████  ██  ██  ██████  ██  ██  ██████████████  ██████████  ██
██          ██  ██  ██              ██  ██      ██                  ██
██  ██████  ██  ██  ██████████████████  ██  ██  ██  ██████████████████
██  ██  ██  ██      ██  ██      ██      ██  ██  ██      ██          ██
██████  ██  ██  ██████  ██  ██  ██  ██████  ██  ██████  ██  ██████  ██
██      ██  ██  ██      ██  ██      ██      ██          ██  ██  ██  ██
██  ██████  ██  ██  ██  ██  ██████████████████████████████  ██  ██  ██
██  ██      ██      ██  ██  ██                          ██      ██  ██
██  ██  ██████████████  ██  ██  ██████████████████████  ██████  ██  ██
██  ██  ██      ██      ██  ██          ██      ██          ██  ██  ██
██  ██  ██  ██████  ██████  ██████████  ██  ██████  ██████████  ██  ██
██  ██  ██      ██  ██  ██              ██      ██              ██  ██
██  ██  ██████  ██  ██  ██████████████  ██████  ██████████  ██████  ██
    ██      ██  ██      ██  ██      ██          ██      ██      ██  ██
██  ██████  ██  ██████  ██  ██  ██  ██████  ██████  ██  ██████████  ██
██      ██  ██              ██  ██  ██      ██      ██              ██
██████  ██  ██████████████████  ██  ██████████  ██████████████████  ██
██      ██          ██      ██  ██              ██              ██  ██
██  ██████████████  ██  ██  ██  ██████████████████  ██████████  ██  ██
██              ██      ██      ██      ██                  ██  ██  ██
██  ██████████  ██████████████████  ██████  ██████████████  ██████  ██
██  ██          ██              ██      ██  ██          ██  ██      ██
██  ██  ██████  ██████████████  ██  ██  ██  ██  ██████  ██  ██  ██████
██  ██      ██              ██      ██  ██  ██  ██      ██      ██  ██
██  ██████  ██████████████  ██  ██████  ██  ██  ██  ██████████████  ██
██  ██      ██          ██  ██  ██      ██  ██  ██                  ██
██  ██  ██████  ██████████  ██████  ██  ██  ██  ██████████████████  ██
██  ██      ██                      ██  ██  ██          ██      ██  ██
██  ██████  ██████████████████████████████  ██████████████  ██  ██  ██
██      ██                                                  ██        
██████████████████████████████████████████████████████████████████████
